#########################
#...........#...........#
#.####.####.#.####.####.#
#.......................#
#.####.#.#######.#.####.#
#......#....#....#......#
######.#### # ####.######
######.#         #.######
######.# ####### #.######
!     .  #     #  .     !
######.# ####### #.######
######.#         #.######
######.# ####### #.######
#...........#...........#
#.####.####.#.####.####.#
#....#.............#....#
####.#.#.#######.#.#.####
#......#....#....#......#
#.#########.#.#########.#
#.......................#
#.......................#
#########################